8 8 8 8 8 8 8 8 8 8 8 8 8 8 8 8 8 8 8 8 8 8 8 8 8 8 8 8 8 8 8 8 8 8 8 8 8 8 8 8 8 8 8 8 8 8 8 8 8 8
8 1 1 0 4 1 0 0 0 0 1 0 1 0 0 0 0 0 0 0 0 0 0 0 0 1 0 0 0 0 0 0 0 0 1 4 0 0 0 0 0 0 0 0 0 0 0 0 0 8
8 0 2 0 0 0 0 2 0 0 0 0 0 0 0 0 0 0 0 0 0 1 0 0 4 0 1 1 0 1 0 0 1 0 0 0 0 0 0 0 0 0 0 0 0 0 0 0 0 8
8 0 0 0 0 0 0 1 0 0 0 0 0 0 0 0 0 0 0 0 2 0 2 0 2 0 9 9 0 0 1 0 0 2 0 1 0 0 0 0 0 0 0 0 0 0 1 0 0 8
8 0 0 0 4 0 0 3 0 0 0 0 1 1 0 0 2 0 0 2 0 0 1 0 0 9 0 1 9 0 0 1 0 0 0 2 3 0 0 0 0 1 2 0 0 0 0 0 0 8
8 0 0 0 1 0 0 0 0 0 0 0 2 0 1 2 0 0 0 0 0 0 0 0 0 0 9 0 0 9 0 0 0 2 0 0 0 0 1 0 1 1 0 0 4 2 0 0 0 8
8 0 2 0 0 0 0 0 0 0 0 0 0 1 0 0 0 0 0 0 0 0 0 0 0 0 0 0 4 0 9 0 1 0 0 0 0 0 0 0 0 0 0 0 0 0 0 0 0 8
8 0 0 0 0 0 0 3 0 0 2 2 2 9 9 0 0 0 0 0 0 0 3 0 0 3 0 0 0 3 0 9 3 0 0 0 0 2 0 0 0 0 0 0 1 0 0 4 2 8
8 3 0 0 0 0 2 2 0 0 3 0 9 9 0 0 0 0 0 0 0 1 0 0 0 2 0 1 0 0 9 9 0 0 0 1 0 0 0 0 0 0 0 0 0 1 0 0 0 8
8 0 1 0 0 0 0 0 0 0 0 0 9 9 1 0 0 0 0 0 0 0 0 0 1 0 1 3 0 0 0 9 9 0 0 0 1 0 0 0 0 1 0 0 0 0 0 0 0 8
8 0 3 0 0 1 0 0 0 0 2 0 9 9 0 2 4 0 0 0 0 0 0 0 0 0 0 0 0 0 0 0 9 9 0 0 0 3 1 0 0 0 1 2 0 0 0 0 0 8
8 0 3 0 0 0 1 0 0 2 0 9 9 0 2 0 0 0 0 0 0 0 2 0 0 0 1 0 0 0 0 0 0 9 9 0 0 0 0 0 0 0 0 0 2 0 0 0 0 8
8 2 1 0 0 1 0 2 0 1 9 9 0 0 1 0 0 0 0 0 0 0 4 0 0 3 0 1 0 0 0 0 0 2 4 9 9 0 0 0 2 4 1 0 0 2 0 0 0 8
8 0 0 0 0 0 3 3 0 9 9 2 0 0 0 0 0 1 0 0 0 0 0 0 3 2 0 0 0 0 4 0 3 0 1 1 9 9 0 0 0 0 0 0 1 0 2 2 0 8
8 0 0 0 0 4 1 0 0 9 9 0 0 0 0 0 0 0 0 0 3 2 0 0 0 0 4 2 0 0 0 0 0 0 4 9 9 0 0 0 0 0 0 0 0 0 2 0 0 8
8 0 2 0 4 0 0 0 9 9 2 0 0 0 0 0 0 1 0 0 0 2 0 4 1 2 0 0 0 0 0 0 0 4 9 9 0 0 0 1 0 0 0 3 2 0 0 0 0 8
8 2 0 0 0 0 0 0 9 9 9 0 0 0 0 0 0 1 2 0 0 0 0 4 0 0 1 2 0 0 0 0 0 9 9 2 0 0 1 0 0 0 2 0 0 0 0 0 0 8
8 0 0 2 0 0 0 0 0 9 9 2 0 0 0 3 0 1 0 2 0 0 0 0 0 0 0 0 0 0 0 0 2 9 9 0 2 0 1 0 2 0 0 0 0 0 2 0 0 8
8 2 0 0 0 0 1 0 1 0 9 9 0 0 0 0 1 0 0 0 0 0 0 0 0 0 0 1 0 0 0 9 9 9 0 0 0 0 0 0 2 0 2 3 0 0 0 0 2 8
8 0 0 0 0 0 0 0 0 2 0 9 9 0 2 3 0 0 0 0 0 0 0 0 0 3 0 0 1 0 9 9 2 2 0 0 0 0 1 0 0 0 3 0 1 0 0 0 3 8
8 0 0 0 0 2 0 0 0 0 0 2 9 9 0 0 0 4 0 0 0 0 4 0 0 0 1 3 0 9 9 0 0 4 0 2 2 0 0 0 0 0 0 0 0 0 0 0 0 8
8 0 0 1 0 0 0 0 1 0 0 0 0 9 9 9 1 4 0 0 0 2 4 0 0 3 2 0 9 9 0 0 2 2 2 0 0 0 0 1 0 3 0 0 0 0 0 0 0 8
8 2 0 0 0 0 0 0 0 0 0 0 0 0 1 9 9 0 0 0 2 0 0 0 0 0 1 2 0 9 9 4 0 0 0 0 0 0 0 1 0 0 0 0 0 3 0 0 1 8
8 0 0 3 0 0 0 0 1 0 0 0 0 0 0 2 9 9 3 0 0 0 0 0 2 0 1 1 9 9 2 0 2 0 0 0 0 0 0 2 1 0 0 0 1 0 0 1 0 8
8 0 0 0 0 0 0 0 0 0 0 4 0 3 0 0 0 2 1 0 2 0 0 0 0 0 3 9 9 0 0 0 1 4 0 0 0 0 3 1 0 0 0 1 0 0 0 1 0 8
8 0 0 0 0 0 0 0 1 0 0 0 0 0 0 0 0 0 0 2 0 0 2 0 0 1 0 9 9 0 2 1 0 0 0 0 4 0 0 0 1 3 0 0 3 0 0 2 0 8
8 0 0 0 4 0 0 1 0 0 0 0 0 0 2 0 0 0 0 0 1 0 3 0 0 0 9 9 0 0 0 0 3 0 0 0 0 0 0 0 0 0 0 2 0 0 4 0 0 8
8 0 0 0 0 0 0 1 0 0 0 2 0 0 4 0 0 0 2 2 0 0 2 0 0 9 9 3 1 0 0 0 0 0 0 0 0 0 1 2 0 0 0 0 0 0 0 0 0 8
8 3 0 0 0 0 0 0 1 0 0 0 0 0 0 1 0 2 4 0 0 0 0 0 0 9 9 0 4 0 0 1 0 2 0 3 2 0 0 2 0 1 0 2 0 0 0 0 0 8
8 0 0 0 0 0 4 0 0 0 0 0 0 0 0 2 0 0 0 0 0 0 9 2 0 0 0 0 2 1 0 0 0 1 2 2 0 0 0 0 2 0 0 0 0 1 0 0 0 8
8 0 3 0 0 0 0 0 0 2 0 0 0 0 1 0 0 0 0 0 0 9 2 2 0 0 0 0 0 0 0 0 4 0 0 4 0 0 0 2 0 0 0 0 0 0 0 2 1 8
8 3 2 1 0 0 2 3 0 0 0 0 0 0 0 0 0 0 0 0 0 2 9 0 0 1 0 2 0 1 0 0 0 0 0 1 4 0 3 0 0 0 1 0 0 0 0 0 0 8
8 0 0 0 0 0 0 1 4 0 0 0 1 0 0 0 0 0 0 0 1 0 0 9 0 0 0 1 0 0 2 0 0 0 0 0 0 0 0 0 3 0 0 0 0 0 1 0 0 8
8 0 0 1 0 0 4 0 0 0 1 0 0 0 0 0 0 0 0 0 0 3 9 0 0 1 0 1 0 0 0 0 0 0 0 0 3 0 0 0 0 1 0 0 0 0 0 0 0 8
8 0 0 0 4 0 1 0 0 3 1 2 0 0 0 0 0 0 3 1 0 9 0 0 1 0 0 0 0 0 0 2 0 4 0 0 2 0 0 0 0 0 0 0 0 3 0 0 3 8
8 0 0 0 0 0 0 0 1 0 0 0 0 0 2 0 0 0 0 0 9 0 0 2 0 0 0 3 1 0 3 1 0 1 0 0 0 0 0 0 0 0 4 0 0 0 0 0 0 8
8 0 2 0 0 2 0 0 0 2 0 0 2 0 0 1 0 0 0 0 0 9 0 1 2 0 0 0 0 0 0 0 2 0 0 4 0 0 0 0 1 0 0 0 0 0 0 2 0 8
8 1 0 1 0 0 0 0 0 1 0 0 1 0 0 0 4 2 0 0 9 9 0 4 0 0 0 0 0 0 0 0 2 0 0 0 0 0 0 0 4 0 0 2 0 0 0 0 0 8
8 0 0 0 1 4 0 0 1 0 0 0 0 0 0 1 0 0 0 0 9 9 0 0 0 2 0 0 0 2 1 4 0 0 0 0 1 0 0 4 0 0 1 0 0 0 2 0 0 8
8 0 0 0 0 0 0 0 0 4 0 0 0 1 0 0 1 0 0 9 9 2 0 0 3 0 1 0 0 0 0 0 0 0 0 0 2 0 1 0 0 0 0 0 0 0 0 2 0 8
8 0 4 4 0 2 0 0 0 1 3 0 0 0 0 1 0 0 0 0 9 9 1 0 0 2 0 0 0 0 0 0 0 0 0 0 0 2 0 2 0 0 0 0 0 0 0 0 0 8
8 0 0 0 0 0 0 0 0 0 0 0 2 1 0 0 0 0 0 0 1 9 0 0 0 0 1 0 0 1 1 4 1 0 0 0 3 1 2 0 0 1 0 0 0 0 0 0 0 8
8 0 0 0 2 0 0 0 0 0 0 4 0 0 0 0 2 0 0 1 9 2 0 0 9 9 2 0 0 0 0 0 9 9 0 0 0 0 1 0 0 0 0 0 0 0 1 0 0 8
8 9 9 0 0 0 0 0 0 0 0 9 9 0 0 2 0 0 0 9 9 9 0 9 9 0 0 0 0 2 0 0 0 9 9 0 2 0 0 0 0 0 0 1 0 0 0 9 9 8
8 9 9 9 9 9 2 0 2 0 9 9 9 9 9 9 0 0 9 9 1 9 9 9 9 0 0 0 0 0 0 2 0 3 9 9 9 0 1 0 0 0 0 0 9 9 0 9 0 8
8 0 0 1 9 9 9 4 9 9 9 0 2 0 9 9 9 9 9 2 0 0 9 0 0 0 0 0 0 0 1 0 0 0 2 9 9 9 0 0 0 2 2 9 9 9 0 1 0 8
8 0 0 3 0 9 9 9 9 9 0 0 0 0 0 9 9 9 0 0 0 0 0 0 0 0 0 0 0 0 0 0 0 2 0 3 2 9 9 9 9 0 9 9 0 0 0 0 1 8
8 1 0 0 0 0 9 9 9 0 0 0 0 0 0 0 1 0 0 0 0 0 0 0 2 0 2 0 0 2 0 0 0 0 0 0 2 0 9 1 9 9 9 1 0 0 0 0 0 8
8 0 0 0 0 0 0 0 0 0 0 1 0 0 0 0 0 0 0 2 0 1 0 0 0 0 0 0 0 3 0 0 1 0 0 0 0 0 2 2 9 9 4 0 0 0 0 0 0 8
8 8 8 8 8 8 8 8 8 8 8 8 8 8 8 8 8 8 8 8 8 8 8 8 8 8 8 8 8 8 8 8 8 8 8 8 8 8 8 8 8 8 8 8 8 8 8 8 8 8
