10 10 10 10 10 10 10 10 10 10 10 10 10 10 10 10 10 10 15 14 14 14 14 14 14 14 14 14 14 14 15 10 10 10 10 10 10 10 10 10 10 10 10 10 10 10 10 10 10 10
10 10 10 10 10 10 10 10 10 10 10 10 10 10 10 10 10 10 15 19 19 19 19 19 19 19 19 19 19 19 15 10 10 10 10 10 10 10 10 10 10 10 10 10 10 10 10 10 10 10
10 10 10 10 10 10 10 10 10 10 10 10 10 10 10 10 10 10 15 11 11 11 11 11 11 11 11 11 11 11 15 10 10 10 10 10 10 10 10 10 10 10 10 10 10 10 10 10 10 10
10 10 10 10 10 10 10 10 10 10 10 10 10 10 10 10 10 10 15 11 11 11 11 11 11 11 11 11 11 11 15 10 10 10 10 10 10 10 10 10 10 10 10 10 10 10 10 10 10 10
10 10 10 10 10 10 10 10 10 10 10 10 10 10 10 10 10 10 22 14 14 14 13 11 11 11 12 14 14 14 17 10 10 10 10 10 10 10 10 10 10 10 10 10 10 10 10 10 10 10
10 10 10 10 10 10 10 10 10 10 10 10 10 10 10 10 10 10 19 19 19 19 15 11 11 11 15 19 19 19 19 10 10 10 10 10 10 10 10 10 10 10 10 10 10 10 10 10 10 10
10 10 10 10 10 10 10 10 10 10 10 10 10 10 10 10 10 10 20 20 20 20 15 11 11 11 15 20 20 20 20 10 10 10 10 10 10 10 10 10 10 10 10 10 10 10 10 10 10 10
10 10 10 10 10 10 10 10 10 10 10 10 10 10 10 10 10 10 10 10 10 10 15 11 11 11 15 10 10 10 10 10 10 10 10 10 10 10 10 10 10 10 10 10 10 10 10 10 10 10
10 10 10 10 10 10 10 10 10 10 10 10 10 10 10 10 10 10 10 10 10 10 15 11 11 11 15 10 10 10 10 10 10 10 10 10 10 10 10 10 10 10 10 10 10 10 10 10 10 10
10 10 10 10 10 10 10 10 10 10 10 10 10 10 10 10 10 10 10 10 10 10 15 11 11 11 15 10 10 10 10 10 10 10 10 10 10 10 10 10 10 10 10 10 10 10 10 10 10 10
10 10 10 10 10 10 10 10 10 10 10 10 10 10 10 10 10 10 10 10 10 10 15 11 11 11 15 10 10 10 10 10 10 10 10 10 10 10 10 10 10 10 10 10 10 10 10 10 10 10
10 10 10 10 10 10 10 10 10 10 10 10 10 10 10 10 10 10 10 10 10 10 15 11 11 11 15 10 10 10 10 10 10 10 10 10 10 10 10 10 10 10 10 10 10 10 10 10 10 10
10 10 10 10 10 10 10 10 12 14 14 14 14 14 14 14 14 14 14 14 14 14 17 14 11 14 22 14 14 14 14 14 14 14 14 14 14 14 14 14 14 13 10 10 10 10 10 10 10 10
10 10 10 10 10 10 10 10 15 19 19 19 19 19 19 19 19 19 19 19 19 19 19 19 11 19 19 19 19 19 19 19 19 19 19 19 19 19 19 19 19 15 10 10 10 10 10 10 10 10
10 10 10 10 10 10 10 10 15 11 11 11 11 11 11 11 11 11 11 11 11 11 11 11 11 11 11 11 11 11 11 11 11 11 11 11 11 11 11 11 11 15 10 10 10 10 10 10 10 10
10 10 10 10 10 10 10 10 15 11 11 11 11 11 11 11 11 11 11 11 11 11 11 11 11 11 11 11 11 11 11 11 11 11 11 11 11 11 11 11 11 15 10 10 10 10 10 10 10 10
10 10 10 10 10 10 10 10 15 11 11 11 11 11 11 11 11 11 11 11 11 11 11 11 11 11 11 11 11 11 11 11 11 11 11 11 11 11 11 11 11 15 10 10 10 10 10 10 10 10
10 10 10 10 10 10 10 10 15 11 11 11 11 11 11 11 11 11 11 11 11 11 11 11 11 11 11 11 11 11 11 11 11 11 11 11 11 11 11 11 11 15 10 10 10 10 10 10 10 10
10 10 10 10 10 10 10 10 15 11 11 11 11 11 11 11 11 11 11 11 11 11 11 11 11 11 11 11 11 11 11 11 11 11 11 11 11 11 11 11 11 15 10 10 10 10 10 10 10 10
10 10 10 10 10 10 10 10 15 11 11 11 11 11 11 11 11 11 11 11 11 11 11 11 11 11 11 11 11 11 11 11 11 11 11 11 11 11 11 11 11 15 10 10 10 10 10 10 10 10
10 10 10 10 10 10 10 10 15 11 11 11 11 11 11 11 11 11 11 11 11 11 11 11 11 11 11 11 11 11 11 11 11 11 11 11 11 11 11 11 11 15 10 10 10 10 10 10 10 10
10 10 10 10 10 10 10 10 15 11 11 11 11 11 11 11 11 11 11 11 11 11 11 11 11 11 11 11 11 11 11 11 11 11 11 11 11 11 11 11 11 15 10 10 10 10 10 10 10 10
10 10 10 10 10 10 10 10 15 11 11 11 11 11 11 11 11 11 11 11 11 11 11 11 11 11 11 11 11 11 11 11 11 11 11 11 11 11 11 11 11 15 10 10 10 10 10 10 10 10
10 10 10 10 10 10 10 10 15 11 11 11 11 11 11 11 11 11 11 11 11 11 11 11 11 11 11 11 11 11 11 11 11 11 11 11 11 11 11 11 11 15 10 10 10 10 10 10 10 10
10 10 10 10 10 10 10 10 15 11 11 11 11 11 11 11 11 11 11 11 11 11 11 11 11 11 11 11 11 11 11 11 11 11 11 11 11 11 11 11 11 15 10 10 10 10 10 10 10 10
10 10 10 10 10 10 10 10 15 11 11 11 11 11 11 11 11 11 11 11 11 11 11 11 11 11 11 11 11 11 11 11 11 11 11 11 11 11 11 11 11 15 10 10 10 10 10 10 10 10
10 10 10 10 10 10 10 10 15 11 11 11 11 11 11 11 11 11 11 11 11 11 11 11 11 11 11 11 11 11 11 11 11 11 11 11 11 11 11 11 11 15 10 10 10 10 10 10 10 10
10 10 10 10 10 10 10 10 15 11 11 11 11 11 11 11 11 11 11 11 11 11 11 11 11 11 11 11 11 11 11 11 11 11 11 11 11 11 11 11 11 15 10 10 10 10 10 10 10 10
10 10 10 10 10 10 10 10 15 11 11 11 11 11 11 11 11 11 11 11 11 11 11 11 11 11 11 11 11 11 11 11 11 11 11 11 11 11 11 11 11 15 10 10 10 10 10 10 10 10
10 10 10 10 10 10 10 10 15 11 11 11 11 11 11 11 11 11 11 11 11 11 11 11 11 11 11 11 11 11 11 11 11 11 11 11 11 11 11 11 11 15 10 10 10 10 10 10 10 10
10 10 10 10 10 10 10 10 15 11 11 11 11 11 11 11 11 11 11 11 11 11 11 11 11 11 11 11 11 11 11 11 11 11 11 11 11 11 11 11 11 15 10 10 10 10 10 10 10 10
10 10 10 10 10 10 10 10 15 11 11 11 11 11 11 11 11 11 11 11 11 11 11 11 11 11 11 11 11 11 11 11 11 11 11 11 11 11 11 11 11 15 10 10 10 10 10 10 10 10
10 10 10 10 10 10 10 10 15 11 11 11 11 11 11 11 11 11 11 11 11 11 11 11 11 11 11 11 11 11 11 11 11 11 11 11 11 11 11 11 11 15 10 10 10 10 10 10 10 10
10 10 10 10 10 10 10 10 15 11 11 11 11 11 11 11 11 11 11 11 11 11 11 11 11 11 11 11 11 11 11 11 11 11 11 11 11 11 11 11 11 15 10 10 10 10 10 10 10 10
10 10 10 10 10 10 10 10 15 11 11 11 11 11 11 11 11 11 11 11 11 11 11 11 11 11 11 11 11 11 11 11 11 11 11 11 11 11 11 11 11 15 10 10 10 10 10 10 10 10
10 10 10 10 10 10 10 10 15 11 11 11 11 11 11 11 11 11 11 11 11 11 11 11 11 11 11 11 11 11 11 11 11 11 11 11 11 11 11 11 11 15 10 10 10 10 10 10 10 10
10 10 10 10 10 10 10 10 22 14 14 14 14 14 14 14 14 14 14 14 14 14 13 18 18 18 12 14 14 14 14 14 14 14 14 14 14 14 14 14 14 17 10 10 10 10 10 10 10 10
10 10 10 10 10 10 10 10 19 19 19 19 19 19 19 19 19 19 19 19 19 19 15 18 18 18 15 19 19 19 19 19 19 19 19 19 19 19 19 19 19 19 10 10 10 10 10 10 10 10
10 10 10 10 10 10 10 10 20 20 20 20 20 20 20 20 20 20 20 20 20 20 15 18 18 18 15 20 20 20 20 20 20 20 20 20 20 20 20 20 20 20 10 10 10 10 10 10 10 10
10 10 10 10 10 10 10 10 10 10 10 10 10 10 10 10 10 10 10 10 10 10 15 11 11 11 15 10 10 10 10 10 10 10 10 10 10 10 10 10 10 10 10 10 10 10 10 10 10 10
10 10 10 10 10 10 10 10 10 10 10 10 10 10 10 10 10 10 10 10 10 10 15 11 11 11 15 10 10 10 10 10 10 10 10 10 10 10 10 10 10 10 10 10 10 10 10 10 10 10
10 10 12 14 14 14 14 14 14 13 10 10 10 10 10 10 10 10 10 10 10 10 15 11 11 11 15 10 10 10 10 10 10 10 10 10 10 10 10 10 10 10 10 10 10 10 10 10 10 10
10 10 15 19 19 19 19 19 19 22 14 14 14 14 14 14 14 14 14 14 14 14 17 11 11 11 15 10 10 10 10 10 10 10 10 10 10 10 10 10 10 10 10 10 10 10 10 10 10 10
10 10 15 11 11 11 11 11 11 19 19 19 19 19 19 19 19 19 19 19 19 19 19 11 11 11 15 10 10 10 10 10 10 10 10 10 10 10 10 10 10 10 10 10 10 10 10 10 10 10
10 10 15 11 23 11 11 11 11 11 11 11 11 11 11 11 11 11 11 11 11 11 11 11 11 11 15 10 10 10 10 10 10 10 10 10 10 10 10 10 10 10 10 10 10 10 10 10 10 10
10 10 15 11 11 11 11 11 11 11 11 11 11 11 11 11 11 11 11 11 11 11 11 11 11 11 15 10 10 10 10 10 10 10 10 10 10 10 10 10 10 10 10 10 10 10 10 10 10 10
10 10 22 14 14 14 14 14 14 14 14 14 14 14 14 14 14 14 14 14 14 14 14 14 14 14 17 10 10 10 10 10 10 10 10 10 10 10 10 10 10 10 10 10 10 10 10 10 10 10
10 10 19 19 19 19 19 19 19 19 19 19 19 19 19 19 19 19 19 19 19 19 19 19 19 19 19 10 10 10 10 10 10 10 10 10 10 10 10 10 10 10 10 10 10 10 10 10 10 10
10 10 20 20 20 20 20 20 20 20 20 20 20 20 20 20 20 20 20 20 20 20 20 20 20 20 20 10 10 10 10 10 10 10 10 10 10 10 10 10 10 10 10 10 10 10 10 10 10 10
10 10 10 10 10 10 10 10 10 10 10 10 10 10 10 10 10 10 10 10 10 10 10 10 10 10 10 10 10 10 10 10 10 10 10 10 10 10 10 10 10 10 10 10 10 10 10 10 10 10