10 10 10 10 10 10 10 10 10 10 10 10 10 10 10 10 10 10 10 12 14 14 14 14 14 14 14 14 14 14 14 14 14 14 14 14 14 14 14 14 14 14 14 14 13 10 10 10 10 10
10 10 10 12 14 14 14 14 14 14 13 10 10 10 10 10 10 10 10 15 19 19 19 19 19 19 19 19 19 19 19 19 19 19 19 19 19 19 19 19 19 19 19 19 15 10 10 10 10 10
10 10 10 15 19 19 19 19 19 19 15 10 10 10 10 10 10 10 10 15 11 11 11 11 11 11 11 11 11 11 11 11 11 11 11 11 11 11 11 11 11 11 11 11 15 10 10 10 10 10
10 10 10 15 11 11 11 11 11 11 15 10 10 10 10 10 10 10 10 15 11 11 11 11 11 11 11 11 11 11 11 11 11 11 11 11 11 11 11 11 11 11 11 11 15 10 10 10 10 10
10 10 10 15 11 11 11 11 11 11 15 10 10 10 10 10 10 10 10 15 11 11 11 11 11 11 11 11 11 11 11 11 11 11 11 11 11 11 11 11 11 11 11 11 15 10 10 10 10 10
10 10 10 15 11 11 11 11 11 11 15 10 10 10 10 10 10 10 10 15 11 11 11 11 11 11 11 11 11 11 11 11 11 11 11 11 11 11 11 11 11 11 11 11 15 10 10 10 10 10
10 10 10 15 11 11 11 11 11 11 15 14 14 14 14 14 14 14 14 14 14 14 11 11 11 14 14 14 14 14 14 14 14 14 14 14 14 14 14 14 14 13 14 14 17 10 10 10 10 10
10 10 10 15 14 14 11 11 14 14 17 19 19 19 19 19 19 19 19 19 19 19 18 18 18 19 19 19 19 19 19 19 19 19 19 19 19 19 19 19 19 15 19 19 19 10 10 10 10 10
10 10 10 15 19 19 11 11 19 19 19 19 19 19 19 19 19 19 19 19 19 19 18 18 18 19 19 19 19 19 19 19 19 19 19 19 19 19 19 19 19 15 19 19 19 10 10 10 10 10
10 10 10 15 11 11 11 11 11 11 11 11 11 11 11 11 11 11 11 11 11 11 11 11 11 11 11 11 11 11 11 11 11 11 11 11 11 11 11 11 11 14 13 20 20 10 10 10 10 10
10 10 10 15 11 11 11 11 11 11 11 11 11 11 11 11 11 11 11 11 11 11 11 11 11 11 11 11 11 11 11 11 11 11 11 11 11 11 11 11 11 19 15 10 10 10 10 10 10 10
10 10 10 15 11 11 11 11 11 11 11 11 11 11 11 11 11 11 11 11 11 11 11 11 11 11 11 11 11 11 11 11 11 11 11 11 11 11 11 11 11 11 15 10 10 10 10 10 10 10
10 12 14 17 11 11 11 11 11 11 11 11 11 11 11 11 11 11 11 11 11 11 11 11 11 11 11 11 11 11 11 11 11 11 11 11 11 11 11 11 11 11 15 10 10 10 10 10 10 10
10 15 19 19 11 11 11 11 11 11 11 11 11 11 11 11 11 11 11 11 11 11 11 11 11 11 11 11 11 11 11 11 11 11 11 11 11 11 11 11 11 11 15 10 10 10 10 10 10 10
10 15 11 11 11 11 11 11 11 11 11 11 11 11 11 11 11 11 11 11 11 11 11 11 11 11 11 11 11 11 11 11 11 11 11 11 11 11 11 11 11 11 15 10 10 10 10 10 10 10
10 15 11 11 11 11 11 11 11 11 11 11 11 11 11 11 11 11 11 11 11 11 11 11 11 11 11 11 11 11 11 11 11 11 11 11 11 11 11 11 11 11 15 10 10 10 10 10 10 10
14 14 14 14 14 14 14 14 14 14 14 14 14 14 14 13 11 11 11 11 11 11 11 11 11 11 11 11 11 11 11 12 14 14 14 14 14 14 14 14 14 14 17 10 10 10 10 10 10 10
19 19 19 19 15 19 19 19 19 19 19 19 19 19 19 15 11 11 11 11 11 11 11 11 11 11 11 11 11 11 11 15 19 19 19 19 19 19 19 19 19 19 19 10 10 10 10 10 10 10
20 20 20 20 15 11 11 11 11 11 11 11 11 11 11 15 11 11 11 11 11 11 11 11 11 11 11 11 11 11 11 15 20 20 20 20 20 20 20 20 20 20 20 10 10 10 10 10 10 10
10 10 10 10 15 11 11 11 11 11 11 11 11 11 11 15 11 11 11 11 11 11 11 11 11 11 11 11 11 11 11 15 10 10 10 10 10 10 10 10 10 10 10 10 10 10 10 10 10 10
10 10 10 10 15 11 11 11 11 11 11 11 11 11 11 15 11 11 11 11 11 11 11 11 11 11 11 11 11 11 11 15 10 10 10 10 10 10 10 10 10 10 10 10 10 10 10 10 10 10
10 10 10 10 15 11 11 11 11 11 11 11 11 11 11 15 11 11 11 11 11 11 11 11 11 11 11 11 11 11 11 15 10 10 10 10 10 10 10 10 10 10 10 10 10 10 10 10 10 10
10 10 10 10 15 11 11 11 11 11 11 11 11 11 11 15 11 11 11 11 11 11 11 11 11 11 11 11 11 11 11 15 10 10 10 10 10 10 10 10 10 10 10 10 10 10 10 10 10 10
10 10 10 10 15 14 11 11 11 14 14 14 14 14 14 14 11 11 11 11 11 11 11 11 11 11 11 11 11 11 11 15 10 10 10 10 10 10 10 10 10 10 10 10 10 10 10 10 10 10
10 10 10 10 15 19 11 11 11 19 19 19 19 19 19 19 11 11 11 11 11 11 11 11 11 11 11 11 11 11 11 14 10 10 10 10 10 10 10 10 10 10 10 10 10 10 10 10 10 10
10 10 10 10 15 11 11 11 11 11 11 11 11 11 11 11 11 11 21 21 15 11 11 11 11 11 15 21 21 21 21 19 10 10 10 10 10 10 10 10 10 10 10 10 10 10 10 10 10 10
10 10 10 10 15 11 11 11 11 11 11 11 11 11 11 11 11 11 20 20 15 11 18 18 18 11 15 20 20 20 20 20 10 10 10 10 10 10 10 10 10 10 10 10 10 10 10 10 10 10
10 10 10 10 15 21 21 21 21 21 21 21 21 21 21 21 21 21 10 10 15 11 18 18 18 11 15 10 10 10 10 10 10 10 10 10 10 10 10 10 10 10 10 10 10 10 10 10 10 10
10 10 10 10 15 20 20 20 20 20 20 20 20 20 20 20 20 20 10 10 15 11 18 18 18 11 15 10 10 10 10 10 10 10 10 10 10 10 10 10 10 10 10 10 10 10 10 10 10 10
10 10 10 10 15 10 10 10 10 10 10 10 10 10 10 10 10 10 10 10 15 11 11 11 11 11 15 10 10 10 10 10 10 10 10 10 10 10 10 10 10 10 10 10 10 10 10 10 10 10
10 10 10 10 15 10 10 10 10 10 10 10 10 10 10 10 10 10 10 10 15 11 11 11 11 11 15 10 10 10 10 10 10 10 10 10 10 10 10 10 10 10 10 10 10 12 14 14 14 13
10 10 10 10 15 10 10 10 10 10 10 10 10 10 10 10 10 10 10 10 15 11 11 11 11 11 15 10 10 10 10 10 10 10 10 10 10 10 10 10 10 10 10 10 10 15 19 19 19 15
10 10 10 10 15 10 10 10 10 10 10 10 10 10 10 10 10 10 10 10 15 11 11 11 11 11 15 10 10 10 10 10 10 10 10 10 10 10 10 10 10 10 10 10 10 15 11 11 11 15
10 10 10 10 15 10 10 10 10 10 10 10 10 10 10 10 10 10 10 10 15 11 11 11 11 11 15 10 10 10 10 10 10 10 10 10 10 10 10 10 10 10 10 10 10 15 11 23 11 15
10 10 10 14 14 14 10 10 10 10 10 10 10 10 10 10 10 10 10 10 15 11 11 11 11 11 15 10 10 10 10 10 10 10 10 10 10 10 10 10 10 10 10 10 10 15 11 11 11 15
10 10 10 19 19 19 10 10 10 10 10 10 10 10 10 10 10 10 10 10 15 11 11 11 11 11 15 10 10 10 10 10 10 10 10 10 10 10 10 10 10 10 10 10 10 15 11 11 11 15
10 10 10 21 21 21 10 10 10 10 10 10 10 10 10 10 10 10 10 10 15 11 11 11 11 11 15 10 10 10 10 10 10 10 10 10 10 10 10 10 10 10 10 10 10 15 11 11 11 15
10 10 10 10 10 10 10 10 10 10 10 10 10 10 10 10 10 10 10 10 15 11 11 11 11 11 22 14 14 14 14 14 14 14 14 14 14 14 14 14 14 14 14 14 14 17 11 11 11 15
10 10 10 10 10 10 10 10 10 10 10 10 10 10 10 10 10 10 10 10 15 11 11 11 11 11 19 19 19 19 19 19 19 19 19 19 19 19 19 19 19 19 19 19 19 19 11 11 11 15
10 10 10 10 10 10 10 10 10 10 10 10 10 10 10 10 10 10 10 10 15 11 11 11 11 11 11 11 11 11 11 11 11 11 11 11 11 11 11 11 11 11 11 11 11 11 11 11 11 15
10 10 10 10 10 10 10 10 10 10 10 10 10 10 10 10 10 10 10 10 15 11 11 11 11 11 11 11 11 11 11 11 11 11 11 11 11 11 11 11 11 11 11 11 11 11 11 11 11 15
10 10 10 10 10 10 10 10 10 10 10 10 10 10 10 10 10 10 10 10 22 14 14 14 14 14 14 14 14 14 14 14 14 13 11 11 11 11 12 14 14 14 14 14 14 14 14 14 14 17
10 10 10 10 10 10 10 10 10 10 10 10 10 10 10 10 10 10 10 10 21 21 21 21 21 21 21 21 21 21 21 21 21 15 11 11 11 11 15 21 21 21 21 21 21 21 21 21 21 21
10 10 10 10 10 10 10 10 10 10 10 10 10 10 10 10 10 10 10 10 20 20 20 20 20 20 20 20 20 20 20 20 20 15 11 11 11 11 15 20 20 20 20 20 20 20 20 20 20 20
10 10 10 10 10 10 10 10 10 10 10 10 10 10 10 10 10 10 10 10 10 10 10 10 10 10 10 10 10 10 10 12 14 17 11 11 11 11 22 14 13 10 10 10 10 10 10 10 10 10
10 10 10 10 10 10 10 10 10 10 10 10 10 10 10 10 10 10 10 10 10 10 10 10 10 10 10 10 10 10 10 15 19 19 11 11 11 11 19 19 15 10 10 10 10 10 10 10 10 10
10 10 10 10 10 10 10 10 10 10 10 10 10 10 10 10 10 10 10 10 10 10 10 10 10 10 10 10 10 10 10 15 10 11 11 11 11 11 11 10 15 10 10 10 10 10 10 10 10 10
10 10 10 10 10 10 10 10 10 10 10 10 10 10 10 10 10 10 10 10 10 10 10 10 10 10 10 10 10 10 10 15 10 11 11 11 11 11 11 10 15 10 10 10 10 10 10 10 10 10
10 10 10 10 10 10 10 10 10 10 10 10 10 10 10 10 10 10 10 10 10 10 10 10 10 10 10 10 10 10 10 22 14 14 14 14 14 14 14 14 17 10 10 10 10 10 10 10 10 10
10 10 10 10 10 10 10 10 10 10 10 10 10 10 10 10 10 10 10 10 10 10 10 10 10 10 10 10 10 10 10 19 19 19 19 19 19 19 19 19 19 10 10 10 10 10 10 10 10 10